fastp	preprocessing
cutadapt	preprocessing
bowtie2	alignment
midas	profiling
humann	profiling
metaphlan	profiling
shogun	profiling
woltka	profiling
flash	paired_read_merging
pear	paired_read_merging
ngmerge	paired_read_merging
bbmerge	paired_read_merging
pooling	coassembly
spades	assembling
quast	assembling
plass	assembling
spades_metaviral	assembling
spades_plasmid	assembling
spades_bio	assembling
flye	assembling
canu	assembling
necat	assembling
megahit	assembling
unicycler	assembling
metawrap_binning	binning
metawrap_refine	binning
metawrap_reassemble	binning
metawrap_blobology	binning
metawrap_quantify	binning
metawrap_classify	binning
metawrap_annotate	binning
deeparg	annotation
prodigal	annotation
macsyfinder	annotation
integronfinder	annotation
search_diamond	annotation
search_hmmer	annotation
prokka	annotation
barrnap	annotation
ccmap	annotation
viralverify	annotation
coconet	annotation
tiara	annotation
antismash	annotation
plasforest	plasmid
plasmidfinder	plasmid
drep	genomics
checkm	genomics
checkm2	genomics
mapping	alignment